NO ./textures/blue_stone_00.xpm
SO ./textures/blue_stone_00.xpm
WE ./textures/blue_stone_00.xpm
EA ./textures/blue_stone_00.xpm

F 220,100,0
C 225,30,0

111111
101001
100001
1000N1
111111
