NO ./textures/blue_stone_00.xpm
SO ./textures/brick_wall_00.xpm
WE ./textures/jungle_wall_00.xpm
EA ./textures/stone_wall_00.xpm
D  ./textures/metal_door.xpm

C 0,128,255
F 10,10,10

111111111111111111111
10100000100000D000001
101010101011111110001
100010100010D00010001
1111101D1111101011101
100000101000101000001
101111101011101111111
101000001010100000101
101011111010111110101
101010001010100010101
101110101010101010101
100000101010001010001
111111101011111011101
100000101000100010001
1D1110101110101110111
101000100000100010101
101011111111111010101
10001000D000000010001
101010111011111111101
1N10000010000000D0001
111111111111111111111
