NO ./textures/blue_stone_00.xpm
SO ./textures/blue_stone_00.xpm
WE ./textures/blue_stone_00.xpm
EA ./textures/blue_stone_00.xpm

F 300,50,50
C 255,255,255

111111
100001
1010N1
111111
